xxxxxxxxxxxxxxxx
x              x
x              x
x              x
x     svs      x
x     vfv      x
x     svs      x
x              x
x              x
x              x
x              x
xxxxxxxxxxxxxxxx
